2
a11111111111
1   11     1
1 1 11     1
1          1
1 1 11     1
1   11115151
111111113131
1      15151
1 221  1 9 1

111111111111
1 11 11 11 1
1    11    1
1          1
11111  11111
1 1 1  11 11
1   11111 11
1   1  11 11
1   7 311111