3
a11111111111
117777777711
151666666141
154177771541
154511214541
154512114541
154166661541
151777777141
116666666611

111111111111
1  111     1
1 1  1 111 1
1 1111 1 1 1
1      1 1 1
1 111111 1 1
1  1  1  1 1
1 111111 1 1
1      11  1

111111111111
1  1111    1
1 1911     1
1 111   1111
1111   18311
1111  111111 
1    1131  1
1   11111  1
1   131    1