4
a11111111111
11   1     1
11   66  2 1
1 11  66   1
1   1 114  1
1 2 1  144 1
1  1311  411
1  11  1   1
1 1    1   1

111111111111
1 1     1  1
1  1   1   1
1 1 1 1    1
11   1 1   1
1   1   1  1
1  1   1 1 1
1 1 1 1   11
11   1     1

111111111111
1  11111  11
11  1   1 11
1111 1111 11
111  511  11
1  11  11111
1 111111 111
11  1 1  111
111 1 1 1111

111111111111
131    1   1
151    111 1
1 1      1 1
1 1  84111 1
1 11158  1 1
1 1      1 1
1 11111111 1
1   191 31 1