3
111111111111
111119111111
111111111111
111111111111
1 1111111121
111111111111
131111111111
111131111111
111111131111

111111111111
146764765571
174567555451
174555776671
145554674761
147765477551
174675557761
144456677571
147567467451

111111111111
15557 655551
155555555551
155555555551
1 77776666 1
144444444441
1 6444444441
1547 6444441
1444547 6441