5
111111111111
13 11  1 131
111651  1 11
1 1471 2 1 1
1  11  11 11
1 1   1 1411
11    11   1
1 1   11 9 1
11 1  8    1

111111111111
1         41
11111    441
14131   4441
14111  44411
141   78 111
141  77 1111
141111111111
11  11111111

111111111111
1       1  1
111     1  1
141    11111
141     1  1
141 1  8   1
141 11111111
111 1 1    1
1  8  1    1

111111111111
1       1  1
111111111  1
1 1    1   1
11 1   1   1
1 1 111 4441
1  1111 5551
1   1 11   1
1    1 1   1
 
111111111111
1411    1  1
166 1      1
14111     11
111   11   1
1   11  1  1
1  1    1111
1  1 4441  1
1   1      1