2
a11111111111
1  1    1  1
1  1    1 21
1  1    1  1
1  1       1
111111111  1
1       1 21
1   9   1  1
111111111111

111111111111
1        131
1       1111
111111111  1
1  1    1  1
1  1    1  1
1  111111111
1       3131
111111111111











a11111111111
1          1
1 2 2  1 1 1
1          1
1111111111 1
1   9    1 1
1        111
1          1
1          1

111111111111
111 1 1 1111
1          1
111111111111
1        111
1        1 1
1          1
1          1
1          1



a11111111111
1 44       1
1 44 2     1
1 44       1
1 44       1
1 44   2   1
1 44       1
1 44       1
1          1

111111111111
1         91
1          1
1          1
1          1
1    1     1
1          1
1       88 1
1          1

a11111111111
1          1
1          1
1          1
1          1
1          1
1          1
1          1
1          1