4
111111111111
1 111  47771
1 131  474 1
11181114 4 1
138289177771
11181115 5 1
1 131  575 1
1 111  57771
111111111111

111111111111
1 1    8   1
1 1 111    1
111 1 7    1
1   1 111181
111 1 7    1
1 1 111    1
1 1    8   1
111111111111

111111111111
1    1     1
151111  1111
1    6  1  1
166118111111
1    6   1 1
1 11 111 7 1
1  1   1 1 1
111111111111

111111111111
11 8  1  811
1  11   1  1
11  11111  1
166118     1
11  11111  1
1  11   11 1
11        81
111111111111
