3
111111111111
1   11     1
1    1     1
1  111     1
1  1982    1
1  111     1
1    1  1141
1   11  6641
111111111111

111111111111
11    1    1
1118111    1
111   1  1 1
1111511  1 1
1111  1  1 1
1111151    1
11111 1   81
111111111111

111111111111
1   667    1
1   445    1
1   131    1
1   14111181
1   1 1    1
1   686  111
1   636  131
111111111111