2
111111111111
111111111111
11111111   1
1      1   1
1 2    8 9 1
1      1   1
11111111   1
111111111111
111111111111

111111111111
113       11
111111111811
1      11 11
1       1311
1      11 11
111111111811
113       11
111111111111