3
a11111111111
1 2 1  1 131
1 1 1  11111
11111      1
1   1      1
1 2 1      1
1  11      1
111111 11111
1     8    1

111111111111
1  11  1   1
11  1 111111
1111111 1  1
1       1  1
111        1
131   111111
1111    13 1
1       1  1

111111111111
11  1    9 1
11   8111111
11111      1
1   11411  1
1   1   1  1
1   7   6  1
1   1   1  1
1   11511111