3
111111111111
1 6626666661
111111115151
1   11315151
1 1 11115151
1     777771
141511411111
1 1 11315551
1 1 11477771

111111111111
111111111111
1111 11 1111
117777777771
114151151411
114666666411
114111111411
1          1
111111111111

111111111111
1    1     1
1    1     1
1  111111  1
1  111911111
111113111  1
1  111111  1
1     1    1
1     1    1