2
111111111111
1  867666651
1 21444111 1
111111111111
18   8     1
1 8   411151
1  8  113771
181111111111
1 8 8 8 8 91

111111111111
11  1771 1 1
11111111 1 1
1      1 1 1
1 1 1 61 1 1
11 81 81 1 1
1 1  131 1 1
1 1111111111
18 8 8 8 831



111111111111
1   11111111
1 2 1      1
11 1181111 1
118   1111 1
1111119111 1
11 1111111 1
11 1111111 1
11         1

111111111111
111   1    1
111 1 1    1
11441 1    1
1     1    1
1111111    1
1          1
1          1
1          1

111111111111
1          1
1          1
1111       1
11 1       1
1111       1
1          1
1          1
1          1