3
111111111111
1  111     1
1 3111   2 1
111111     1
111111111111
1          1
1          1
1          1
1          1

111111111111
1     1    1
1   1 1    1
1 111 1    1
1 131 1    1
1 111 1    1
1 1   1    1
1     111111
1          1

111111111111
131   1    1
111   1    1
1     1    1
1     1    1
1     1    1
1    11111 1
1    1 9 1 1
1    11111 1