3
111111111111
1   1      1
1      1   1
111111111111
1      1   1
1      1   1
11111  1   1
1 9 12 1   1
1   1  1   1

111111111111
1       1  1
1       1  1
1111    1  1
1  1    1  1
13 1    1  1
111111111111
1 3  11    1
1    11    1

111111111111
1          1
1          1
1          1
111111111111
1   1 31   1
111111111111
1          1
1          1