3
111111111111
111111111 21
1       1  1
1       1  1
111111  1  1
1    1  1  1
1    1  1  1
111  1  1  1
131  1  1  1

111111111111
1         11
11111111  11
1      1  11
1      1  11
11111  1  11
1   1  1  11
1   1  1  11
1   1  1 311

111111111111
13       1 1
1        1 1
1111111  1 1
1     1  1 1
1     1  1 1
1111  1  1 1
1 91  1  1 1
1  1  1  1 1