2
a11111111111
1314 41  111
157 8 6  111
1  898   111
1 7 8 611111
1115 51  111
1 6665  55 1
1 64 5  1211
1 6477  12 1

111111111111
1       1111
111141  1 31
1  716  1 11
1  1511116 1
11    1  5 1
1 1   151181
1311 1 51  1
1 8 1  56  1