3
a11111111111
1          1
1 11111111 1
1 1 7226 1 1
141111111141
14   18   41
11   81   11
11   18   11
11   81   11

111111111111
1  1    1  1
1  11  11  1
111 1111 111
177571165661
15151  15151
131 1 31 131
1 1 1  1 1 1
1 6  11  7 1

111111111111
1          1
11111  11111
1   1991   1
1   1111   1
1    11    1
1 11 76 11 1
1 1  76  1 1
1    76    1