4
111111111111
155555555551
151515555551
151515551151
151115551551
155555551151
155511111551
155555531111
155555555521

111111111111
166666666661
161616666661
161616661161
161116661961
166666661161
166611111661
166666661111
166666666661

111111111111
144444444441
141414444441
141314441141
141114441441
144444441141
144411111341
144444441111
144444444441

111111111111
177777777771
171717777771
171717771171
171117771771
177777771171
177711111771
177777771111
177777777771

