3
111111111111
12     1   1
1 111111   1
1 136661   1
1 111111   1
1   11     1
1   11 11111
1   11 1 9 1
1   1  1   1

111111111111
1   1 1  1 1
1  14 1  1 1
1 11 1  11 1
1 11  177  1
1 1 1 1111 1
111 1 1  1 1
1   1 1  1 1
1   1 1  1 1

111111111111
1    11    1
15   11 3 51
175  11  561
1 75111156 1
1  75 356  1
1   75561111
1    76    1
1    11    1