2
a11111111111
1    11    1
1  2 11  2 1
1    11    1
1111118    1
1    16    1
1    1611111
1    16    1
11111119   1

a11111111111
1    11    1
1111111    1
1    1111111
1   31    31
1    1111111
1111111    1
1    11    1
1   9113   1



a11111111111
1 44       1
1 44 2     1
1 44       1
1 44       1
1 44   2   1
1 44       1
1 44       1
1          1

111111111111
1         91
1          1
1          1
1          1
1    1     1
1          1
1       88 1
1          1