6
111111111111
1          1
1 2        1
11111111   1
1          1
1  111111111
1  1 11    1
1  1111    1
1          1

111111111111
1      1   1
1   1  1   1
1  1   1  11
1   1  1   1
1 111111  11
1  1 3 1   1
1 111111  11
1      1   1

111111111111
1          1
1    11    1
111   1 1111
1    1111  1
1  11111   1
1111 1 1   1
1  111 1   1
1          1

111111111111
1   1  1   1
11111      1
1   1111   1
1          1
11111      1
1 3  111   1
11111      1
1      1   1

111111111111
191        1
111    1   1
1 1    1   1
111    1   1
1      1   1
1 111111  11
1  1     1 1
1   1   1  1

111111111111
1    11    1
1   1  1   1
1111 11 1  1
1   1  1   1
1   1  1   1
1  1    1  1
11  1111  11
1 1      131