2
111111111111
1      1   1
1      1 3 1
1      1   1
1      1   1
111111111111
1      1   1
1    2 1 9 1
1      1   1

111111111111
1   1      1
1   1 3    1
1   1      1
1   1      1
1   11111  1
1   1   1  1
1   1 3 1  1
1   1   1  1

111111111111
1          1
1          1
1          1
1          1
1          1
1          1
1          1
1          1