2
111111111111
1112   11111
11111  11111
1          1
1 1111111  1
11189838   1
1   11111411
1      8   1
111111111111

111111111111
1 36 11  3 1
141111141151
18   11    1
141111111151
1   111    1
141111111151
1    11    1
111111111111