2
111111111111
1    6666551
1 2  6636551
1    6666551
111111115551
111111115351
1  66 775551
1 966 777771
1  66 777771

111111111111
1   77777771
1   77777371
1   77777771
144411111111
144711111111
144777777771
147777777771
147777777771