3
111111111111
12      7731
111111 11111
188888 88881
188888 888 1
188888 888 1
1888    88 1
1888888888 1
18   8888881

111111111111
1       77 1
111111 11111
188888888881
1888 8888881
1888 8883 81
188888888881
188888888881
18888888   1

111111111111
1          1
111111 11111
188888888881
1883888   81
188888888881
188888888881
188988888881
18888   8881