2
111111111111
19  8   8 81
1 1111 8 8 1
1 1381 11111
181811     1
1 111      1
1          1
11111    811
18 8     121

111111111111
1  1   8 831
1  1    8 81
1118  111111
1          1
1          1
1       1111
111111  1  1
138 81  1  1