4
111111111111
1 5   16  71
1 6 1416  71
11111 114141
1  7 2 6 131
11111 111111
1  1151  1 1
1 1 1 1411 1
11 91   6  1

111111111111
117777777711
131111111141
151 5555 141
151666657141
151647777141
151 4444 141
151111111141
116666666611

111111111111
1   1    1 1
1  1    1  1
1 11   11111
11  1 1    1
1    1 111 1
1   11 131 1
1  7 1 151 1
1 1  1     1

111111111111
1  1       1
1     111111
11111  1   1
11       1 1
1  1 11111 1
1 11     1 1
1  111 1 1 1
114  6     1

111111111111
1          1
1          1
1          1
1          1
1          1
1          1
1          1
1          1