2
111111111111
1 1        1
1 11111111 1
1 55555355 1
1 5555515521
1 55555155 1
1 55555555 1
1 55555555 1
1 1666666661

111111111111
1 1666666661
1 44444444 1
1 44444444 1
1941114444 1
1 41314444 1
1 41114444 1
1111111111 1
131        1