4
111111111111
1 1111111131
1 1   6   51
1   1111   1
1 111291   1
1   111111 1
118   11 111
1     1  111
1     1  771

111111111111
1 1111111111
111        1
1   111    1
1   181    1
11111 111  1
11811   8  1
1   11111111
1        131

111111111111
181111111111
1   111    1
1    5     1
1111181    1
1131111111 1
1181117 61 1
1181111111 1
1          1

111111111111
1          1
111111111111
1  1151    1
1111181    1
1  111111111
1    1 1   1
1    1 15551
1    1   1 1