2
111111111111
1        1 1
1111111111 1
131    1 1 1
1 1  9 131 1
1 11111111 1
1 1      131
111111111111
12         1

111111111111
1 1        1
1 1111111111
1 1      1 1
1 1    1 1 1
11111111 1 1
1      1 1 1
1111111111 1
1        1 1