4
111111111111
1   1      1
1   1      1
111111111111
1   1191   1
1   1211   1
111111111111
1      1   1
1      1   1

111111111111
1     1    1
1     1    1
1     1    1
111111     1
1     111111
1    1     1
1    1     1
1    1     1

111111111111
1   1111   1
1  1  1 1  1
1 1   1  1 1
111111 11111
11111 111111
1 1  1   1 1
1  1 1  1  1
1   1111   1

111111111111
1 1 1  1 1 1
1 1 13 1 1 1
1 111111 1 1
1 1 11 131 1
1 1 1 11 1 1
1 1 111111 1
1 1 1 31 1 1
1 1 1  1 1 1