3
111111111111
12  111   11
11   111  91
111111111111
1   1  1   1
1   1  1   1
111111111111
1          1
11        11

111111111111
1      1   1
1      1   1
11111  11111
1 3 1  1 3 1
1   1  1   1
11111  11111
1   1      1
1   1      1

111111111111
131  1  1  1
11  1  1  11
1  1  1  1 1
1 1  1  1  1
11  1  1  11
1  1  1  1 1
1 1  1  1  1
11  1  1  11