2
111111111111
1     9    1
1          1
144444444441
144444444441
144444444441
1  11  11  1
1 31 2  13 1
1  1    1  1

111111111111
1    3     1
1          1
155555555551
155555555551
155555555551
1  1    1  1
1   1  1   1
1   1111   1