2
a11111191111
1  111111  1
1  111111  1
1  111111  1
1   1111   1
1  111111  1
1  111111  1
1  111111  1
12 111119 21

111111111111
1  111111  1
1  113111  1
1  111111  1
1  111111  1
1   1111   1
1  111111  1
1  131131  1
1  111111  1